18 18 18 18 18 18 18 18 18 18 18 18 18 18 30 21 21 21 21 21 21 21 21 31 18 18 18 18 18 18 18 18 18 18 18 18 18 18 18 18 18 18 18 18 18 18 18 18 18 18 18 18 18 18 18 18 18 18 18 18 18 18 18 18 18 18 18 18 18 18 18 18 18 18 18 18 18 18 18 18 18 18 18 18 18 18 18 18 18 18 18 18 18 18 18 18 18 18 18 18 
32 32 23 18 18 18 18 18 18 18 18 18 18 18 18 18 18 18 18 18 18 18 18 18 18 18 18 18 18 18 18 18 18 18 18 18 18 18 18 18 18 18 18 18 18 18 18 18 18 18 18 18 18 18 18 18 18 18 18 18 18 18 18 18 18 18 18 18 18 18 18 18 18 18 18 18 18 18 18 18 18 18 18 18 18 18 18 18 18 18 18 18 18 18 18 18 18 18 18 18 
32 32 23 18 18 18 18 18 18 18 18 18 18 18 18 18 18 18 18 18 18 18 18 18 18 18 18 18 18 18 18 18 18 18 18 19 18 18 18 18 18 18 18 18 18 18 18 18 18 18 18 18 18 18 18 18 18 18 18 18 18 18 18 18 18 18 18 18 18 18 18 18 18 18 18 18 18 18 18 18 18 18 18 18 18 18 18 18 18 18 18 18 18 18 18 18 18 18 18 18 
32 32 23 18 18 18 18 18 18 18 18 18 18 18 18 18 18 18 18 18 18 18 18 18 18 18 18 18 18 18 18 18 18 18 18 18 18 18 18 18 19 18 18 18 18 18 18 18 18 18 18 18 18 18 18 18 18 18 18 18 18 18 18 18 18 18 18 18 18 18 18 18 18 18 18 18 18 18 18 18 18 18 18 18 18 18 18 18 18 18 18 18 18 18 18 18 18 18 18 18 
32 32 23 18 18 18 18 18 18 18 18 18 18 18 18 18 18 18 18 18 18 18 18 18 18 18 18 18 18 18 18 18 18 18 18 18 19 18 18 18 18 18 18 18 18 18 18 18 18 18 18 18 18 18 18 18 18 18 18 18 18 18 18 18 18 18 18 18 18 18 18 18 18 18 18 18 18 18 18 18 18 18 18 18 18 18 18 18 18 18 18 18 18 18 18 18 18 18 18 18 
32 32 23 18 18 18 19 18 18 18 18 18 18 18 18 19 18 18 18 18 18 18 18 18 18 18 19 18 18 18 18 18 18 18 18 18 18 18 18 18 18 18 18 18 18 18 18 18 18 19 19 18 18 18 18 18 18 18 18 18 18 18 18 18 18 18 18 18 18 18 18 18 18 18 18 18 18 18 18 18 18 18 18 18 18 18 18 18 18 18 18 18 18 18 18 18 18 18 18 18 
32 32 23 18 18 18 18 18 18 18 18 18 18 18 18 18 18 18 18 18 18 18 18 18 18 18 18 18 18 18 18 19 19 18 18 18 18 18 18 18 18 18 18 18 18 18 18 18 18 19 18 18 18 18 18 18 18 18 18 18 18 18 18 18 18 18 18 18 18 18 18 18 18 18 18 18 18 18 18 18 18 18 18 18 18 18 18 18 18 18 18 18 18 18 18 18 18 18 18 18 
32 32 23 18 18 18 18 18 18 18 18 18 18 18 18 18 18 18 18 18 18 18 18 18 18 18 18 18 18 18 18 18 18 18 19 18 18 18 18 18 18 18 18 18 18 18 18 18 18 18 18 18 18 18 18 18 18 18 18 18 18 18 19 18 18 18 18 18 18 18 18 18 18 18 18 18 18 18 18 18 18 18 18 18 18 18 18 18 18 18 18 18 18 18 18 18 18 18 18 18 
32 32 23 18 18 18 18 18 18 18 18 18 18 18 18 18 18 18 18 18 18 18 18 18 18 18 18 18 18 18 18 18 19 18 18 18 18 18 18 18 18 18 18 19 19 18 18 18 18 18 18 18 18 18 18 18 18 18 18 18 18 18 19 18 18 18 18 18 18 18 18 18 19 19 19 19 19 18 18 18 18 18 18 18 18 18 18 18 18 18 18 18 18 18 18 18 18 18 18 18 
32 32 23 18 18 18 18 18 18 18 19 18 18 18 18 18 18 18 18 18 18 18 18 18 18 18 18 18 18 18 18 18 19 18 18 18 18 18 18 18 18 18 18 18 18 18 18 18 18 18 18 18 18 18 18 18 18 19 18 18 18 19 18 18 18 18 18 18 18 18 18 18 18 18 18 18 19 18 18 18 18 18 18 18 18 18 18 18 18 18 18 18 18 18 18 18 18 18 18 18 
32 32 23 18 18 18 18 18 18 18 18 18 18 18 18 18 18 18 18 18 19 18 18 18 18 18 18 18 18 18 18 18 18 18 18 18 18 18 18 19 18 18 18 18 18 18 18 18 18 18 18 18 18 19 18 18 18 19 19 19 18 18 18 18 18 18 18 18 18 18 18 18 18 18 18 18 18 19 18 18 18 18 18 18 18 18 18 18 18 18 18 18 18 18 18 18 18 18 18 18 
32 32 23 18 18 18 18 18 18 18 18 18 18 18 18 18 18 18 18 18 18 18 18 18 18 18 18 18 18 18 18 18 18 18 18 18 18 18 18 18 18 18 18 18 18 18 18 18 18 18 18 18 18 18 18 18 18 18 18 18 18 18 18 18 18 18 18 18 18 18 18 18 18 18 18 18 18 18 18 18 18 18 18 18 18 18 18 18 18 18 18 18 18 18 18 18 18 18 18 18 
32 32 25 26 26 26 26 26 26 26 26 26 26 26 26 26 26 26 26 26 26 26 26 26 26 26 26 26 26 26 26 26 26 26 26 26 26 26 26 26 26 26 26 26 26 26 26 26 26 26 26 26 26 26 26 26 26 26 26 26 26 26 26 26 29 18 18 18 18 18 18 18 18 18 18 18 18 18 18 18 18 18 18 18 18 18 18 18 18 18 18 18 18 18 18 18 18 18 18 18 
32 32 16 16 16 16 16 16 16 16 16 16 16 16 16 16 16 16 16 16 16 16 16 16 16 16 16 16 16 16 16 16 16 16 16 16 16 16 16 16 16 16 16 16 16 16 16 16 16 16 16 16 16 16 16 16 16 16 16 16 16 16 16 16 23 18 18 18 18 18 18 18 18 18 18 18 18 18 18 18 18 18 18 18 18 18 18 18 18 18 18 18 18 18 18 18 18 18 18 18 
32 32 16 16 16 16 16 16 16 16 16 16 16 16 16 16 16 16 16 16 16 16 16 16 16 16 16 16 16 16 16 16 16 16 16 16 16 16 16 16 16 16 16 16 16 16 16 16 16 16 16 16 1 1 1 16 16 16 16 16 16 16 16 16 23 18 18 19 18 18 18 18 18 18 18 18 18 18 18 18 18 18 18 18 18 18 18 18 18 18 18 18 18 18 18 18 18 18 18 18 
32 32 16 16 16 16 16 16 16 16 16 16 16 16 16 16 16 16 16 16 16 16 16 16 16 16 16 16 16 16 16 16 16 16 16 16 16 16 16 16 16 16 16 16 16 16 16 16 16 16 16 16 1 33 1 16 16 16 16 16 16 16 16 16 23 18 18 18 18 18 18 18 18 18 18 18 18 18 18 18 18 18 18 18 18 18 18 18 18 18 18 18 18 18 18 18 18 18 18 18 
32 32 16 16 16 16 16 16 16 16 16 16 16 16 16 16 16 16 16 16 16 16 16 16 16 16 16 16 16 16 16 16 16 16 16 16 16 16 1 1 16 16 16 16 16 16 16 16 16 16 16 16 1 1 1 16 16 16 16 16 16 16 16 16 23 18 18 18 18 18 18 18 18 18 18 18 18 18 18 18 18 18 18 18 18 18 18 18 18 18 18 18 18 18 18 18 18 18 18 18 
32 32 1 1 16 16 16 16 16 16 16 16 16 16 16 1 16 16 16 16 16 16 16 16 16 16 16 16 16 16 16 16 16 16 16 16 1 1 1 16 16 16 16 16 16 16 16 16 16 16 16 16 16 1 16 16 16 16 16 16 16 16 16 16 23 18 18 18 18 18 18 18 18 18 18 18 18 18 18 18 18 18 18 18 18 18 18 18 18 18 18 18 18 18 18 18 18 18 18 18 
32 32 1 1 16 16 16 16 16 16 16 16 16 16 16 1 16 16 16 16 16 16 16 16 16 16 16 16 16 16 16 16 16 16 16 16 1 16 16 16 16 16 16 16 16 16 16 16 16 16 16 16 16 1 16 16 16 16 16 16 16 16 16 16 23 18 18 18 18 18 18 18 18 18 18 18 18 18 18 18 18 18 18 18 18 18 18 18 18 18 18 18 18 18 18 18 18 18 18 18 
32 32 1 1 1 16 16 16 16 16 16 16 16 16 16 1 16 16 16 16 16 16 16 16 16 16 16 16 16 16 16 16 16 16 16 16 1 16 16 16 16 16 16 16 16 16 16 16 16 16 16 16 16 1 16 16 16 16 16 16 16 16 16 16 23 18 18 18 18 19 18 18 18 18 18 18 18 18 18 18 18 18 18 18 18 18 18 18 18 18 18 18 18 18 18 18 18 18 18 18 
32 32 1 1 1 1 16 16 16 16 16 16 16 16 16 1 16 16 16 16 16 16 16 16 16 16 16 16 16 16 16 16 16 16 16 16 1 16 16 16 16 16 16 16 16 16 16 16 16 16 16 16 16 1 16 16 16 16 16 16 16 16 16 16 23 18 18 18 18 18 18 18 18 18 18 18 19 18 18 18 18 18 18 18 18 18 18 18 18 18 18 18 18 18 18 18 18 18 18 18 
32 32 1 1 1 1 1 2 2 12 10 10 10 10 10 10 10 10 10 10 10 10 10 10 10 10 10 10 10 10 10 10 10 10 10 10 10 10 10 10 10 10 13 2 16 16 16 16 16 16 16 16 16 1 16 16 16 16 16 16 16 16 16 16 23 18 18 18 18 18 18 18 18 18 18 18 18 18 18 18 18 18 18 18 18 18 18 18 18 18 18 18 18 18 18 18 18 18 18 18 
32 32 32 1 1 1 1 2 2 8 3 3 3 3 3 3 3 3 3 3 3 3 3 3 3 3 3 3 3 3 3 3 3 3 3 3 3 3 3 3 3 3 7 2 16 16 16 16 16 16 16 16 1 1 16 16 16 16 16 16 16 16 16 16 23 18 18 18 18 18 18 18 18 18 18 18 18 18 18 18 18 18 18 18 18 18 18 18 18 18 18 18 18 18 18 18 18 18 18 18 
32 32 32 32 1 1 1 1 2 8 3 3 3 3 3 3 3 3 3 3 3 3 3 3 3 3 3 3 3 3 3 3 3 3 3 3 3 3 3 3 3 3 7 2 16 16 16 16 16 16 16 1 1 1 1 16 16 16 16 16 16 16 16 16 23 18 18 18 18 18 18 19 18 18 18 18 18 18 18 18 18 18 18 18 18 18 18 18 18 18 18 18 18 18 18 18 18 18 18 18 
32 32 32 32 32 1 1 1 1 8 3 3 3 3 3 3 3 3 3 3 3 3 3 3 3 3 3 3 3 3 3 3 3 3 3 3 3 3 3 3 3 3 7 2 16 16 16 16 16 16 16 16 16 16 1 1 16 16 16 16 16 16 16 16 23 18 18 18 18 18 18 19 18 18 18 18 18 18 18 18 18 18 18 18 18 18 18 18 18 18 18 18 18 18 18 18 18 18 18 18 
32 32 32 32 32 1 1 1 1 8 3 3 3 3 3 3 3 3 3 3 3 3 3 3 3 3 3 3 3 3 3 3 3 3 3 3 3 3 3 3 3 3 7 2 2 16 16 16 16 16 16 16 1 16 16 1 16 16 16 16 16 16 16 16 23 18 18 18 18 18 18 18 18 18 18 18 18 18 18 18 18 18 18 18 18 18 18 18 18 18 18 18 18 18 18 18 18 18 18 18 
32 17 32 32 32 32 1 1 1 8 3 3 3 3 3 3 3 3 3 3 3 3 3 3 3 3 3 3 3 3 3 3 3 3 3 3 3 3 3 3 3 3 7 2 2 2 2 2 2 2 2 16 1 1 16 1 16 16 16 1 16 16 16 16 23 18 18 18 18 18 18 18 18 18 18 18 18 18 18 18 18 18 18 18 18 18 18 18 18 18 18 18 18 18 18 18 18 18 18 18 
32 17 17 32 32 32 32 1 1 8 3 3 3 3 3 3 3 3 3 3 3 3 3 3 3 3 3 3 3 3 3 3 3 3 3 3 3 3 3 3 3 3 9 10 10 10 10 10 10 10 10 10 10 10 10 10 10 10 13 1 16 16 16 16 23 18 18 18 18 18 18 18 18 18 18 18 18 18 18 18 18 18 18 18 18 18 18 18 18 18 18 18 18 18 18 18 18 18 18 18 
32 17 17 17 32 32 32 32 1 8 3 3 3 3 3 3 3 3 3 3 3 3 3 3 3 3 3 3 3 3 3 3 3 3 3 3 3 3 3 3 3 3 3 3 3 3 3 3 3 3 3 3 3 3 3 3 3 3 7 16 16 16 16 16 23 18 18 18 18 18 18 18 18 19 18 18 18 18 18 18 18 18 18 18 18 18 18 18 18 18 18 18 18 18 18 18 18 18 18 18 
32 17 17 17 17 32 32 32 1 8 3 3 3 3 3 3 3 3 3 3 3 3 3 3 3 3 3 3 3 3 3 3 3 3 3 3 3 3 3 3 3 3 3 3 3 3 3 3 3 3 3 3 3 3 3 3 3 3 7 16 16 16 16 16 23 18 18 18 18 18 18 18 18 19 18 18 18 18 18 18 18 18 18 18 18 18 18 18 18 18 18 18 18 18 18 18 18 18 18 18 
32 17 17 17 17 17 32 32 1 8 3 3 3 3 3 3 3 3 3 3 3 3 3 3 3 3 3 3 3 3 3 3 3 3 3 3 3 3 3 3 3 3 3 3 3 3 3 3 3 3 3 3 3 3 3 3 3 3 7 16 16 16 16 16 23 18 18 18 18 19 18 18 18 18 18 18 18 18 18 18 18 18 18 18 18 18 18 18 18 18 18 18 18 18 18 18 18 18 18 18 
32 17 17 17 17 17 17 32 2 8 3 3 3 3 3 3 3 3 3 3 3 3 3 3 3 3 3 3 3 3 3 3 3 3 3 3 3 3 3 3 3 3 3 3 3 3 3 3 3 3 3 3 3 3 3 3 3 3 7 16 16 16 16 16 23 18 18 18 18 18 18 18 18 18 18 18 18 18 18 18 18 18 18 18 18 18 18 18 18 18 18 18 18 18 18 18 18 18 18 18 
32 36 17 17 17 17 17 17 2 8 3 3 3 3 3 3 3 3 3 3 3 3 3 3 3 3 3 3 3 3 3 3 3 3 3 3 3 3 3 3 3 3 3 3 3 3 3 3 3 3 3 3 3 3 3 3 3 3 7 16 16 16 16 16 23 18 18 18 18 18 18 18 18 18 18 18 19 18 18 18 18 18 18 18 18 18 18 18 18 18 18 18 18 18 18 18 18 18 18 18 
32 17 17 17 17 17 17 32 2 8 3 3 3 3 3 3 3 3 3 3 3 3 3 3 3 3 3 3 3 3 3 3 3 3 3 3 3 3 3 3 3 3 3 3 3 3 3 3 3 3 3 3 3 3 3 3 3 3 7 16 16 16 16 16 23 18 18 18 18 18 18 18 18 18 18 18 18 18 18 18 18 18 18 18 18 18 18 18 18 18 18 18 18 18 18 18 18 18 18 18 
32 17 17 17 17 17 32 32 2 8 3 3 3 3 3 3 3 3 3 3 3 3 3 3 3 3 3 3 3 3 3 3 3 3 3 3 3 3 3 3 3 3 3 3 3 3 3 3 3 3 3 3 3 3 3 3 3 3 7 16 16 16 16 16 23 18 18 18 19 18 18 18 18 18 18 18 18 18 18 18 18 18 18 18 18 18 18 18 18 18 18 18 18 18 18 18 18 18 18 18 
32 17 17 17 17 32 32 32 2 8 3 3 3 3 3 3 3 3 3 3 3 3 3 3 3 3 3 3 3 3 3 3 3 3 3 3 3 3 3 3 3 3 3 3 3 3 3 3 3 3 3 3 3 3 3 3 3 3 7 16 16 16 16 16 25 26 26 26 26 26 26 26 26 26 29 18 18 18 18 18 18 18 18 18 18 18 18 18 18 18 18 18 18 18 18 18 18 18 18 18 
32 17 17 17 32 32 32 32 2 8 3 3 3 3 3 3 3 3 3 3 3 3 3 3 3 3 3 3 3 3 3 3 3 3 3 3 3 3 3 3 3 3 3 3 3 3 3 3 3 3 3 3 3 3 3 3 3 3 7 16 16 16 16 16 16 16 16 16 16 16 16 16 16 16 25 29 18 18 18 18 18 18 18 18 18 18 18 18 18 18 18 18 18 18 18 18 18 18 18 18 
32 17 32 32 32 32 32 32 1 8 3 3 3 3 3 3 3 3 3 3 3 3 3 3 3 3 3 3 3 3 3 3 3 3 3 3 3 3 3 3 3 3 3 3 3 3 3 3 3 3 3 3 3 3 3 3 3 3 7 16 16 16 16 16 16 16 16 16 16 16 16 16 16 16 16 25 29 18 18 18 18 18 18 18 18 18 18 18 18 18 18 18 18 18 18 18 18 18 18 18 
32 32 32 32 32 32 2 2 2 8 3 3 3 3 3 3 3 3 3 3 3 3 3 3 3 3 3 3 3 3 3 3 3 3 3 3 3 3 3 3 3 3 3 3 3 3 3 3 3 3 3 3 3 3 3 3 3 3 7 2 16 16 16 16 16 16 16 16 16 16 16 16 16 16 16 16 25 29 18 18 18 18 18 18 18 18 18 18 18 18 18 18 18 18 18 18 18 18 18 18 
32 32 32 32 32 2 2 2 16 8 3 3 3 3 3 3 3 3 3 3 3 3 3 3 3 3 3 3 3 3 3 3 3 3 3 3 3 3 3 3 3 3 3 3 3 3 3 3 3 3 3 3 3 3 3 3 3 3 7 2 16 16 16 16 16 16 16 16 16 16 16 16 16 16 16 16 16 23 18 18 18 18 18 18 18 18 18 18 18 18 18 18 18 18 18 18 18 18 18 18 
32 32 32 32 2 2 1 1 16 14 5 5 5 5 5 5 5 5 5 5 5 5 5 5 5 6 3 3 3 3 3 3 3 3 3 3 3 3 3 3 3 3 3 3 3 3 3 3 3 3 3 3 3 3 3 3 3 3 7 2 16 16 16 16 16 16 16 16 16 1 1 16 16 16 16 16 16 23 18 18 18 18 18 18 18 18 18 18 18 18 18 18 18 18 18 18 18 18 18 18 
32 32 2 2 2 1 1 1 16 1 1 1 16 16 1 16 1 1 1 1 1 1 1 1 1 8 3 3 3 3 3 3 3 3 3 3 3 3 3 3 3 3 3 3 3 3 3 3 3 3 3 3 3 3 3 3 3 3 7 2 16 16 16 16 16 16 16 16 1 1 1 1 16 16 16 16 16 23 18 18 18 18 18 18 18 18 18 18 18 18 18 18 18 18 18 18 18 18 18 18 
32 32 2 1 16 16 16 1 16 16 16 1 1 16 16 1 16 16 1 1 16 1 1 1 1 8 3 3 3 3 3 3 3 3 3 3 3 3 3 3 3 3 3 3 3 3 3 3 3 3 3 3 3 3 3 3 3 3 7 1 1 1 16 16 16 16 16 16 16 1 1 16 16 16 16 16 16 23 18 18 18 18 18 18 18 18 18 18 18 18 18 18 18 18 18 18 18 18 18 18 
32 32 16 16 16 16 16 16 16 1 16 16 16 1 16 16 16 16 16 16 16 1 1 1 1 8 3 3 3 3 3 3 3 3 3 3 3 3 3 3 3 3 3 3 3 3 3 3 3 3 3 3 3 3 3 3 3 3 7 1 1 1 16 16 16 1 16 16 16 1 16 16 16 16 16 16 16 23 18 18 18 18 18 18 18 18 18 18 18 18 18 18 18 18 18 18 18 18 18 18 
32 32 16 16 16 16 16 16 16 16 16 16 16 16 16 16 16 16 1 16 16 16 16 1 1 8 3 3 3 3 3 3 3 3 3 3 3 3 3 3 3 3 3 3 3 3 3 3 3 3 3 3 3 3 3 3 3 3 7 1 1 16 16 16 1 1 1 16 16 16 16 16 1 16 16 16 16 23 18 18 18 18 18 18 18 18 18 18 18 18 18 18 18 18 18 18 18 18 18 18 
32 32 16 16 16 16 1 1 16 1 1 16 16 16 16 1 16 16 16 16 16 1 16 16 1 8 3 3 3 3 3 3 3 3 3 3 3 3 3 3 3 3 3 3 3 3 3 3 3 3 3 3 3 3 3 3 3 3 7 1 16 16 16 16 16 16 16 16 16 16 16 16 16 1 16 16 16 23 18 18 18 18 18 18 18 18 18 18 18 18 18 18 18 18 18 18 18 18 18 18 
32 32 16 16 16 16 1 1 1 1 16 16 16 16 16 16 16 1 16 16 16 16 16 1 1 14 5 5 6 3 3 3 3 3 3 3 3 3 3 3 3 3 3 4 5 5 5 5 5 5 5 5 5 5 5 5 5 5 15 1 16 16 16 16 16 16 16 16 16 16 16 16 16 1 16 16 16 23 18 18 18 18 18 18 18 18 18 18 18 18 18 18 18 18 18 18 18 18 18 18 
32 32 16 16 16 16 16 16 16 16 16 16 16 16 16 16 16 1 16 16 16 16 16 1 1 1 1 12 11 3 3 3 3 3 3 3 3 3 3 3 3 3 4 15 1 1 1 1 1 1 1 1 1 1 1 1 1 1 1 1 16 16 16 32 32 32 32 32 32 32 16 16 16 16 1 16 16 23 18 18 18 18 18 18 18 18 18 18 18 18 18 18 18 18 18 18 18 18 18 18 
32 32 16 16 16 16 16 16 16 16 16 16 16 16 1 1 16 16 1 1 16 16 1 1 1 1 1 8 3 3 3 3 3 3 3 3 3 3 3 3 3 4 15 1 1 1 1 1 16 16 1 1 16 1 1 1 1 1 1 16 16 16 16 32 1 1 1 1 1 32 16 16 16 1 1 16 16 23 18 18 18 18 18 18 18 18 18 18 18 18 18 18 18 18 18 18 18 18 18 18 
32 32 20 21 21 21 21 21 21 21 21 21 22 16 16 1 1 16 16 1 16 16 16 16 1 1 1 8 3 3 3 3 3 3 3 3 3 3 3 4 5 15 1 1 1 1 1 16 16 16 16 16 16 16 16 16 16 16 16 16 16 16 16 32 1 1 1 1 1 32 16 16 16 1 16 16 16 23 18 18 18 18 18 18 18 18 18 18 18 18 18 18 18 18 18 18 18 18 18 18 
32 32 23 18 18 18 18 18 18 19 19 19 24 16 16 16 1 1 16 1 16 16 16 16 1 1 1 14 5 5 5 5 5 5 5 5 5 5 5 15 1 1 1 1 1 1 16 16 16 16 16 16 16 16 16 16 16 16 16 16 16 16 16 32 1 1 1 1 1 32 16 16 16 1 16 16 16 23 18 18 18 18 18 18 18 18 18 18 18 18 18 18 18 18 18 18 18 18 18 18 
32 32 23 18 18 18 18 18 18 18 18 18 24 16 16 16 16 16 16 16 1 16 16 16 1 1 1 1 1 1 1 1 1 1 1 1 1 1 1 1 1 2 2 2 1 16 16 16 16 16 16 16 16 16 16 16 16 16 16 16 16 16 16 32 1 1 1 1 1 32 16 16 16 1 1 16 16 23 18 18 18 18 18 18 18 18 18 18 18 18 18 18 18 18 18 18 18 18 18 18 
32 32 23 18 18 18 18 18 18 18 18 18 24 16 16 16 16 16 16 16 16 16 16 16 1 1 1 1 1 1 1 1 1 1 1 1 1 1 1 1 2 2 1 1 16 16 16 16 16 16 16 16 16 16 16 16 16 16 16 16 16 16 16 32 32 32 1 32 32 32 16 16 16 16 16 16 16 23 18 18 18 18 18 18 18 18 18 18 18 18 18 18 18 18 18 18 18 18 18 18 
32 32 23 18 18 18 18 18 18 18 18 18 24 16 16 16 16 16 16 1 1 16 16 16 1 1 1 1 1 1 1 1 1 1 1 1 1 1 1 1 1 2 2 16 16 16 16 1 1 16 16 16 16 16 16 16 16 16 16 16 16 16 16 16 16 16 1 16 16 16 16 16 16 16 16 16 16 23 18 18 18 18 18 18 18 18 18 18 18 18 18 18 18 18 18 18 18 18 18 18 
32 32 23 18 18 19 18 18 18 18 18 18 24 16 16 16 16 16 1 1 16 16 16 16 1 1 16 16 16 16 16 16 16 16 16 16 16 16 16 16 16 16 16 16 16 1 1 1 16 16 16 16 16 16 16 1 1 1 16 16 16 16 16 16 16 16 1 16 16 16 16 16 16 16 16 16 16 23 18 18 18 18 18 18 18 18 18 18 18 18 18 18 18 18 18 18 18 18 18 18 
32 32 23 18 18 18 18 18 18 18 18 18 24 16 16 16 16 16 1 1 16 16 16 16 1 1 16 16 16 16 16 16 16 16 16 16 16 16 16 16 16 16 16 16 16 1 16 16 16 16 16 16 16 16 16 16 1 1 1 16 16 16 16 16 16 1 1 16 16 16 16 16 16 16 16 16 16 25 26 26 29 18 18 18 18 18 18 18 18 18 18 18 18 18 18 18 18 18 18 18 
21 21 31 18 18 18 18 18 18 18 18 18 24 16 16 16 16 16 1 16 16 16 16 16 1 1 16 16 16 16 16 16 16 1 1 16 16 16 16 16 16 16 16 16 16 16 16 16 16 16 16 16 16 16 16 16 16 16 1 1 16 16 16 16 16 1 1 16 16 16 16 16 16 1 16 16 16 1 1 1 23 18 18 18 18 18 18 18 18 18 18 18 18 18 18 18 18 18 18 18 
18 18 18 19 18 18 18 18 18 18 18 18 24 16 16 16 16 1 1 16 16 16 16 16 1 1 16 16 16 16 16 16 1 1 16 16 16 16 16 16 16 16 16 16 16 16 16 16 1 1 16 16 16 16 16 16 16 16 1 1 16 16 16 16 16 1 16 16 16 16 16 16 16 1 16 16 16 16 1 1 23 18 18 18 18 18 18 18 18 18 18 18 18 18 18 18 18 18 18 18 
18 18 18 18 18 18 18 18 18 18 18 18 24 16 16 16 16 1 16 16 16 16 16 16 1 1 16 16 16 16 1 1 1 16 16 16 16 16 16 1 16 16 16 16 16 16 16 16 16 1 16 16 16 16 16 16 16 16 1 16 16 16 16 16 16 1 16 16 16 16 16 16 1 1 16 16 16 16 1 1 23 18 18 18 18 28 26 26 26 26 26 26 26 26 26 26 26 26 26 26 
18 18 18 18 18 18 18 18 18 18 18 18 24 16 16 16 16 1 16 16 16 1 16 16 1 1 16 16 16 16 1 16 16 16 16 16 16 16 16 1 16 16 16 16 16 16 16 16 16 1 1 16 16 16 16 16 16 16 16 1 16 16 16 1 1 1 16 16 16 16 16 16 1 16 16 16 16 16 1 1 23 18 18 18 18 24 12 11 3 3 3 3 3 3 3 3 3 3 3 3 
18 18 18 18 18 18 18 18 19 18 18 18 24 16 16 16 16 1 16 16 1 1 16 16 1 1 16 16 16 16 16 16 16 16 16 16 16 1 1 1 16 16 16 16 16 16 1 1 1 1 1 1 1 1 1 1 1 16 16 16 16 16 1 1 16 16 16 16 16 16 16 1 1 16 16 16 16 16 1 1 23 18 18 18 18 24 8 3 3 3 3 3 3 3 3 3 3 3 3 3 
18 18 18 18 18 18 18 18 18 18 18 18 24 16 16 16 16 16 16 16 1 16 16 16 1 1 16 16 16 16 1 1 1 1 1 1 1 1 16 16 16 16 16 16 16 16 1 16 16 1 1 16 16 16 16 16 16 16 16 16 16 16 1 16 16 16 16 16 16 16 16 1 16 16 16 16 16 16 1 1 23 18 18 18 18 24 8 3 3 3 3 3 3 3 3 3 3 3 3 3 
18 18 18 18 18 18 18 18 18 18 18 18 24 16 16 16 16 1 16 16 16 16 16 16 1 1 16 16 16 16 1 1 16 16 16 16 1 1 16 16 16 16 16 16 16 1 1 16 16 16 1 16 16 16 16 16 16 16 16 16 16 16 1 16 16 16 16 16 16 16 1 1 1 16 16 16 16 16 1 1 23 18 18 18 18 24 14 5 5 5 6 3 3 3 3 3 3 3 3 3 
18 18 18 18 18 18 18 18 18 18 18 18 24 16 16 16 16 1 16 16 16 16 16 16 1 1 16 16 16 16 16 1 1 16 16 1 1 16 16 16 16 16 16 16 16 1 16 16 16 16 1 1 16 16 16 16 16 16 16 16 16 16 1 1 1 1 1 1 1 1 1 1 1 16 16 16 16 16 1 16 23 18 18 18 18 30 21 21 21 22 8 3 3 3 3 3 3 3 3 3 
18 18 18 18 18 18 18 18 18 18 18 18 24 16 16 16 16 1 16 16 16 16 16 16 1 1 16 16 16 16 16 16 1 16 16 1 16 16 16 16 16 16 16 16 1 1 16 16 16 16 16 16 16 16 16 16 16 16 16 16 16 16 16 1 16 16 16 16 16 16 16 16 1 16 16 16 16 16 1 16 23 18 18 18 18 18 18 18 18 24 8 3 3 3 3 3 3 3 3 3 
18 18 18 18 18 18 18 18 18 18 18 18 24 16 16 16 1 1 16 16 16 1 16 16 1 1 1 1 1 1 1 1 1 16 1 1 16 16 16 16 16 16 1 1 1 16 16 16 16 16 16 16 16 16 16 16 16 16 16 16 16 16 16 1 16 16 16 16 16 16 16 16 1 16 16 16 16 16 1 1 23 18 18 18 18 19 18 18 18 24 8 3 3 3 3 3 3 3 3 3 
18 18 18 18 18 18 18 18 18 18 18 18 24 16 16 16 1 1 1 16 16 1 1 16 1 1 1 16 16 1 1 1 16 16 1 1 1 1 1 1 1 1 1 1 16 16 16 16 16 16 16 16 16 16 1 1 1 1 16 16 16 16 16 1 1 16 16 16 16 16 16 16 1 16 16 16 16 16 1 16 23 18 18 18 18 18 18 18 18 24 8 3 3 3 3 3 3 3 3 3 
18 18 18 18 18 19 19 18 18 18 18 18 24 16 16 16 1 1 1 16 16 16 1 1 1 1 1 1 1 1 1 16 16 16 16 16 16 1 16 16 16 16 16 1 16 16 16 16 16 1 1 1 1 1 1 2 2 1 1 1 16 16 16 16 1 16 16 16 16 16 16 1 1 16 16 16 16 16 1 16 23 18 18 18 18 18 18 18 18 30 22 5 5 5 5 5 5 5 5 5 
18 18 18 18 18 18 18 18 18 18 18 18 24 16 16 16 16 16 1 16 16 16 16 1 1 16 16 16 16 1 1 16 16 16 16 16 16 1 16 16 16 16 16 1 1 16 16 16 1 1 1 16 16 16 16 16 2 2 2 2 1 1 16 1 1 16 16 16 16 16 16 1 16 16 16 16 16 16 1 16 23 18 18 18 18 18 18 18 18 19 30 21 21 21 21 21 21 21 21 21 
18 18 18 18 18 18 18 18 18 18 18 18 24 16 16 16 16 16 1 1 1 1 1 1 1 16 16 16 16 1 1 16 16 16 16 16 1 1 16 16 16 16 16 16 1 1 16 16 1 16 1 2 16 16 16 16 1 16 16 2 1 2 16 1 16 16 16 16 16 1 1 1 16 16 16 16 16 16 1 16 23 18 18 18 18 18 18 19 18 18 18 19 19 18 18 18 18 18 18 18 
18 18 19 19 19 18 18 18 18 18 18 18 24 16 16 16 16 16 16 16 16 1 1 1 1 1 16 16 16 16 1 16 16 16 16 1 1 16 16 16 16 16 16 16 16 1 1 1 1 16 16 2 16 16 16 16 1 16 16 16 1 1 1 1 1 1 1 1 1 1 16 16 16 16 16 16 16 16 1 16 23 18 18 18 18 18 18 18 18 18 18 18 18 18 19 18 18 19 18 18 
18 18 18 18 18 18 18 18 19 18 18 18 24 16 16 16 16 16 16 16 16 1 1 1 1 1 1 1 16 16 16 2 2 16 16 1 16 16 16 16 16 16 1 2 2 1 1 16 16 16 16 1 16 16 16 1 1 16 16 16 1 16 16 16 1 1 1 16 16 16 16 16 16 16 16 1 16 16 1 16 23 18 18 19 18 18 18 18 18 18 18 18 18 18 18 18 18 18 18 19 
18 19 18 18 18 18 18 18 18 18 18 18 30 21 21 22 16 16 16 16 16 16 16 16 16 1 1 1 16 16 16 16 2 16 16 1 1 1 1 16 16 2 2 2 16 16 16 16 16 16 16 1 16 16 16 1 1 16 16 16 1 16 16 16 16 1 1 16 16 16 16 16 16 16 16 1 1 1 1 16 23 18 18 18 18 18 18 28 26 26 29 18 18 18 18 18 18 18 18 18 
18 18 18 18 18 18 18 18 18 18 18 18 18 18 18 24 16 16 16 16 16 1 16 16 16 16 1 1 16 16 16 16 16 1 1 1 16 16 1 16 1 2 16 16 16 16 16 16 16 16 16 1 1 16 16 16 1 1 16 16 1 16 16 16 16 1 1 16 16 16 16 1 1 16 16 16 16 1 1 16 23 18 18 18 18 28 26 27 16 16 23 18 18 19 18 18 18 18 19 18 
18 18 18 18 18 18 18 18 18 18 18 18 18 18 18 24 16 16 16 16 1 1 16 16 16 1 1 1 1 16 16 16 16 16 16 16 1 1 1 16 16 2 16 16 16 16 16 16 16 16 16 16 1 16 16 16 16 1 16 16 1 16 16 16 16 1 1 16 16 1 1 1 16 16 16 16 1 1 16 16 23 18 18 18 28 27 1 1 1 16 23 18 18 18 18 18 18 18 18 18 
18 18 18 18 18 18 18 18 18 18 18 18 18 18 18 24 16 16 16 1 1 16 16 16 16 1 1 1 16 16 16 16 16 16 16 16 16 16 1 16 1 2 16 16 16 1 1 1 16 16 16 16 1 16 16 16 16 1 16 16 16 16 16 16 16 1 1 16 1 1 16 16 16 16 16 1 1 2 16 16 23 18 18 18 24 16 1 1 1 2 23 18 18 18 18 18 18 18 18 28 
18 18 18 18 18 18 18 18 18 18 18 18 18 18 18 24 16 16 16 16 1 1 16 16 16 1 1 1 16 16 16 16 16 16 16 16 16 16 1 2 2 16 16 16 16 1 16 1 1 16 16 16 1 16 16 16 16 1 1 16 16 1 1 1 16 2 2 1 1 16 16 16 16 16 1 1 1 16 16 16 23 18 18 18 24 16 1 1 1 16 23 18 18 18 18 19 18 18 28 27 
18 18 18 18 18 18 18 18 18 18 18 18 18 18 18 24 16 16 16 16 16 1 16 16 16 16 1 1 16 16 16 16 16 16 16 16 16 16 1 2 1 16 16 16 16 1 16 16 1 16 16 16 1 1 16 16 16 16 1 1 1 1 16 16 16 2 1 1 16 16 16 16 16 16 16 16 1 1 16 16 23 18 18 28 27 1 1 1 1 16 23 18 18 18 18 18 18 28 27 16 
18 18 18 18 18 18 18 18 18 18 18 18 18 18 18 24 16 16 16 16 1 1 1 1 1 1 1 1 16 16 16 16 16 16 16 16 16 16 2 2 16 16 16 16 1 16 16 16 1 1 16 16 16 1 16 16 16 16 16 1 1 16 16 16 16 2 2 16 16 16 1 1 1 1 1 1 1 1 16 16 23 18 28 27 1 1 2 2 1 16 23 18 18 18 18 18 28 27 16 16 
18 18 18 18 18 18 18 18 18 18 18 18 18 18 18 24 16 16 16 16 1 1 1 1 1 1 1 2 2 2 2 2 16 16 16 16 16 16 2 1 16 16 16 1 1 16 16 16 16 16 16 16 16 1 16 1 1 16 16 16 16 16 16 16 16 1 1 16 1 1 1 16 16 16 16 16 1 1 16 16 23 28 27 16 1 2 1 1 1 16 23 18 18 18 19 18 24 16 16 16 
18 18 18 18 18 18 18 18 18 18 18 18 18 18 18 30 21 22 16 16 16 16 16 1 1 1 1 1 1 1 2 2 2 16 16 16 16 2 1 16 16 16 1 1 16 16 1 1 16 16 16 16 16 1 1 1 1 16 16 16 16 16 16 16 1 1 1 1 16 16 16 16 16 1 16 2 2 1 16 16 23 24 16 16 2 2 1 1 16 20 31 18 18 18 18 18 24 16 16 16 
18 18 18 18 18 18 18 18 18 18 18 18 18 18 18 18 18 30 22 16 16 16 16 16 16 16 16 16 16 1 1 1 2 2 2 16 16 2 1 16 16 1 1 16 16 16 16 1 1 1 16 1 1 1 16 1 16 16 16 16 16 16 1 1 16 1 1 1 1 1 1 1 1 1 1 2 1 1 16 16 25 27 1 1 2 1 1 16 20 31 18 18 18 18 18 18 24 16 16 16 
18 18 18 18 18 18 18 18 18 18 18 18 18 18 18 18 18 18 30 21 22 16 16 16 16 16 16 16 16 16 16 16 1 1 1 2 2 1 1 16 16 16 16 16 16 16 16 16 16 1 1 1 16 16 16 1 16 16 16 16 1 1 1 1 1 1 16 16 16 16 16 1 1 1 16 16 1 1 1 16 1 1 1 1 1 2 2 20 31 18 18 18 19 18 18 18 30 22 16 16 
18 18 18 18 18 18 18 18 18 18 18 18 18 18 18 18 18 18 18 18 30 22 16 16 16 1 1 1 1 16 16 16 16 16 1 1 1 1 16 16 16 16 16 16 16 16 16 16 16 16 1 1 1 16 1 1 16 16 16 1 1 16 1 1 16 16 16 16 1 1 1 1 1 1 1 16 1 16 1 16 1 1 1 2 2 2 20 31 18 18 19 18 18 18 18 18 28 27 16 16 
18 18 18 18 18 18 18 18 18 18 18 18 18 18 18 18 18 18 18 18 18 30 21 22 16 16 16 16 1 1 16 16 16 16 16 16 16 16 16 1 1 16 16 16 1 16 16 16 16 16 1 16 1 1 1 1 2 2 1 16 1 1 1 16 16 1 1 1 1 1 1 1 1 2 2 1 16 1 1 1 1 1 1 2 2 20 31 18 18 18 18 18 18 18 18 18 24 16 16 16 
18 18 18 18 18 18 18 18 18 18 18 18 18 18 18 18 18 18 18 18 18 18 18 30 21 21 22 16 16 16 16 16 16 16 16 16 16 16 1 1 16 16 16 16 1 1 1 1 16 1 1 16 16 1 1 1 2 2 1 1 16 1 1 1 1 16 16 1 1 1 1 16 16 2 2 1 1 1 1 1 1 1 16 2 20 31 18 18 18 18 18 18 18 18 19 18 30 21 21 21 
18 18 18 18 18 18 18 18 18 18 18 18 18 18 18 18 18 18 18 18 18 18 18 18 18 18 30 21 22 16 16 16 16 16 1 1 1 1 1 16 16 16 16 16 16 16 16 1 1 1 16 16 1 1 1 2 2 2 1 16 16 1 1 16 16 1 1 1 1 1 1 1 1 1 1 1 1 1 1 1 1 1 16 20 31 18 18 18 18 18 18 18 18 18 18 18 18 18 18 18 
18 18 18 18 18 18 18 18 18 18 18 18 18 18 18 18 18 18 18 18 18 18 18 18 18 18 18 18 30 21 22 16 16 16 16 16 16 16 16 16 16 16 16 16 16 16 1 2 2 1 16 1 1 16 16 1 1 1 16 16 16 1 16 1 1 1 1 1 1 1 16 16 16 1 1 1 1 1 1 1 16 16 20 31 18 18 18 18 18 19 18 18 18 18 18 18 18 18 18 18 
18 18 18 18 18 18 18 18 18 18 18 18 18 18 18 18 18 18 18 18 18 18 18 18 18 18 18 18 18 18 30 22 16 16 16 16 16 16 16 16 16 16 16 16 1 1 2 2 16 1 2 1 1 1 1 1 16 16 16 16 1 1 1 2 2 1 1 2 2 1 1 16 1 1 1 1 1 1 16 1 16 20 31 18 18 18 19 18 18 18 18 18 18 18 18 18 18 18 18 18 
18 18 18 18 18 18 18 18 18 18 18 18 18 18 18 18 18 18 18 18 18 18 18 18 18 18 18 18 18 18 18 30 21 22 16 16 16 1 1 1 1 1 1 1 1 2 2 16 16 1 1 1 1 1 16 1 1 1 16 1 1 1 1 2 2 1 1 2 2 1 1 1 1 1 1 1 1 1 1 1 1 23 18 18 18 18 18 18 18 18 18 18 19 18 18 18 18 18 18 18 
18 18 18 18 18 18 18 18 18 18 18 18 18 18 18 18 18 18 18 18 18 18 18 18 18 18 18 18 18 18 18 18 18 30 22 16 16 16 16 16 16 16 16 16 16 16 16 16 16 16 16 1 16 16 16 1 1 16 1 1 1 16 16 1 1 1 1 2 1 1 1 1 1 1 1 2 2 1 1 1 1 23 18 18 19 18 18 18 18 18 18 18 18 18 18 18 18 18 18 18 
18 18 18 18 18 18 18 18 18 18 18 18 18 18 18 18 18 18 18 18 18 18 18 18 18 18 18 18 18 18 18 18 18 18 30 21 22 16 16 16 16 16 16 16 16 16 16 16 16 16 16 1 1 16 16 16 16 1 16 1 1 1 1 16 16 1 1 1 1 1 1 1 1 1 2 2 1 1 1 1 16 23 18 18 18 18 18 19 19 18 18 18 18 18 18 18 18 18 18 18 
18 18 18 18 18 18 18 18 18 18 18 18 18 18 18 18 18 18 18 18 18 18 18 18 18 18 18 18 18 18 18 18 18 18 18 18 30 21 21 21 21 21 21 21 21 21 22 16 16 16 16 16 16 16 16 16 16 16 16 16 16 16 16 1 1 1 16 16 16 16 16 1 1 1 1 1 1 1 1 1 20 31 18 18 18 18 18 18 18 18 18 18 18 18 18 18 18 18 18 18 
18 18 18 18 18 18 18 18 18 18 18 18 18 18 18 18 18 18 18 18 18 18 18 18 18 18 18 18 18 18 18 18 18 18 18 18 18 18 18 18 18 18 18 18 18 18 30 21 21 21 21 21 21 21 21 21 21 21 21 21 21 21 21 21 21 21 21 21 21 21 21 21 21 21 21 21 21 21 21 21 31 18 18 18 19 18 18 18 18 18 18 18 18 18 18 18 18 18 18 18 
18 18 18 18 18 18 18 18 18 18 18 18 18 18 18 18 18 18 18 18 18 18 18 18 18 18 18 18 18 18 18 18 18 18 18 18 18 18 18 18 18 18 18 18 18 18 18 18 18 18 18 18 18 18 18 18 18 18 18 18 18 18 18 18 18 18 18 19 18 18 18 18 18 18 18 18 18 18 18 18 18 18 19 18 18 18 18 18 18 18 18 18 18 18 18 18 18 18 18 18 
18 18 18 18 18 18 18 18 18 18 18 18 18 18 18 18 18 18 18 18 18 18 18 18 18 18 18 18 18 18 18 18 18 18 18 18 18 18 18 18 18 18 18 18 18 18 18 18 18 18 18 18 18 18 18 18 18 18 18 18 18 18 18 18 18 18 18 18 18 18 18 18 19 18 18 18 18 18 18 18 18 18 18 18 18 18 19 18 18 18 18 18 18 18 18 18 18 18 18 18 
18 18 18 18 18 18 18 18 18 18 18 18 18 18 18 18 18 18 18 18 18 18 18 18 18 18 18 18 18 18 18 18 18 18 18 18 18 18 18 18 18 18 18 18 18 18 18 18 18 18 18 18 18 18 18 18 18 18 18 18 18 18 18 18 18 18 18 18 18 18 18 18 18 18 18 18 18 18 19 18 18 18 18 18 18 18 18 18 18 18 19 18 18 18 18 18 18 18 18 18 
18 18 18 18 18 18 18 18 18 18 18 18 18 18 18 18 18 18 18 18 18 18 18 18 18 18 18 18 18 18 18 18 18 18 18 18 18 18 18 18 18 18 18 18 18 18 18 18 18 18 18 18 18 18 18 18 18 18 18 18 18 18 18 18 18 18 18 18 18 18 18 18 18 18 18 18 18 18 18 18 18 18 18 18 18 18 18 18 18 18 18 18 18 18 18 18 18 18 18 18 
18 18 18 18 18 18 18 18 18 18 18 18 18 18 18 18 18 18 18 18 18 18 18 18 18 18 18 18 18 18 18 18 18 18 18 18 18 18 18 18 18 18 18 18 18 18 18 18 18 18 18 18 18 18 18 18 18 18 18 18 18 18 18 18 18 18 18 18 18 19 18 18 18 18 18 18 18 18 18 18 18 18 18 18 18 19 18 18 18 18 18 18 18 18 18 18 18 18 18 18 
18 18 18 18 18 18 18 18 18 18 18 18 18 18 18 18 18 18 18 18 18 18 18 18 18 18 18 18 18 18 18 18 18 18 18 18 18 18 18 18 18 18 18 18 18 18 18 18 18 18 18 18 18 18 18 18 18 18 18 18 18 18 18 18 18 18 18 18 18 18 18 18 18 18 18 18 18 18 18 18 18 18 18 18 18 18 18 18 18 18 18 18 18 18 18 18 18 18 18 18 
